1. Staples & Dry Groceries
Rice: Basmati Rice, Sona Masoori, White Rice, Brown Rice, Parboiled Rice, Ponni Rice, Jasmine Rice, Arborio Rice, Wild Rice
Flours: Whole Wheat Atta, Multigrain Atta, Maida, Cake Flour, Besan, Ragi Flour, Bajra Flour, Jowar Flour, Sooji, Corn Flour, Almond Flour
Pulses (Dal): Toor Dal, Moong Dal (Split & Whole), Chana Dal, Urad Dal (Split & Whole), Masoor Dal, Black Gram, Horse Gram, Rajma, Kabuli Chana
Sugar & Sweeteners: White Sugar, Brown Sugar, Jaggery (Gur), Powdered Sugar, Palm Sugar, Stevia, Honey, Maple Syrup, Date Syrup, Erythritol
Salt: Iodised Salt, Rock Salt (Sendha Namak), Black Salt (Kala Namak), Sea Salt, Himalayan Pink Salt, Low-Sodium Salt
Cereals & Grains: Rolled Oats, Instant Oats, Steel-cut Oats, Muesli, Cornflakes, Quinoa, Couscous, Vermicelli, Poha, Dalia, Barley, Foxtail Millet, Little Millet, Sorghum
Noodles & Pasta: Maggi, Yippee, Top Ramen, Hakka Noodles, Rice Noodles, Udon, Spaghetti, Penne, Fusilli, Macaroni, Lasagna Sheets, Fettuccine, Farfalle
Baking Essentials:
 – Dry: Baking Powder, Baking Soda, Dry Yeast, Icing Sugar, Custard Powder, Cocoa Powder
 – Wet: Vanilla Essence, Almond Essence, Rose Water, Lemon Extract
 – Add-ins: Choco Chips, Sprinkles, Food Coloring (Liquid & Gel), Edible Glitter
Other Staples: Tamarind Paste, Asafoetida (Hing), Puffed Rice (Murmura), Sabudana, Poha Flakes

2. Spices, Herbs & Seasonings
Ground Spices: Haldi, Lal Mirch Powder, Dhania Powder, Jeera Powder, Amchur, Garam Masala, Sambar Powder, Biryani Masala, Chaat Masala, Curry Powder, Onion Powder, Garlic Powder
Whole Spices: Jeera, Mustard Seeds (Rai), Fenugreek Seeds, Fennel Seeds, Ajwain, Cinnamon Sticks, Cloves, Green Cardamom, Black Cardamom, Black Peppercorns, Bay Leaves, Star Anise, Nutmeg, Mace, Stone Flower (Dagad Phool)
Herbs & Blends: Paprika, Smoked Paprika, Crushed Red Pepper, Oregano, Basil, Thyme, Rosemary, Sage, Marjoram, Italian Seasoning, Herbes de Provence, Za’atar
Specialty Blends: Lemon Pepper, Garlic Salt, Celery Salt, Kitchen King Masala

3. Oils, Ghee, Fats & Vinegars
Cooking Oils: Sunflower Oil, Groundnut Oil, Mustard Oil, Olive Oil (Extra Virgin, Pomace), Coconut Oil (Refined, Virgin), Rice Bran Oil, Canola Oil, Sesame Oil, Corn Oil, Blended Oil
Ghee & Butter: Cow Ghee, Buffalo Ghee, Vanaspati Ghee, Amul Butter, Britannia Butter, White Butter (Makhan), Salted Butter, Unsalted Butter
Fats & Creams: Margarine, Vegetable Shortening (Dalda), Cooking Cream, Whipping Cream, Sour Cream, Cream Cheese
Vinegars & Acids: White Vinegar, Apple Cider Vinegar, Balsamic Vinegar, Red Wine Vinegar, Lemon Juice (Bottled), Lime Juice

4. Sauces, Condiments, Chutneys & Pickles
Sauces: Tomato Ketchup, Soy Sauce (Light & Dark), Sriracha, Chili Garlic Sauce, Worcestershire Sauce, BBQ Sauce, Teriyaki Sauce, Hoisin Sauce, Oyster Sauce, Fish Sauce, Sweet & Sour Sauce, Steak Sauce
Condiments: Mustard (Yellow, Dijon, Whole Grain), Mayonnaise, Miracle Whip, Horseradish, Relish (Sweet & Dill), Salsa (Mild, Medium, Hot), Pesto, Tahini
Chutneys & Pickles: Mango Pickle, Lime Pickle, Mixed Vegetable Pickle, Coconut Chutney, Mint Chutney, Tamarind Chutney, Tomato Chutney

5. Beverages
Tea: Black Tea (Assam, Darjeeling), Green Tea, Herbal Tea (Chamomile, Peppermint), Masala Chai, Instant Tea Premix, Iced Tea RTD
Coffee: Instant Coffee (Nescafé, Bru), Filter Coffee Powder, Ground Coffee, Coffee Beans (Arabica, Robusta), Coffee Pods
Health Drinks: Horlicks, Bournvita, Boost, Complan, Protinex, Ensure, Pediasure, Protein Shake Mixes (Whey, Plant-based)
Soft Drinks & Juices: Coca-Cola, Pepsi, Sprite, Thums Up, Frooti, Real, Tropicana, Paper Boat, Maaza, Rooh Afza, Minute Maid
Water & Specialty: Packaged Drinking Water, Sparkling Water, Coconut Water (Tender, Packaged), Kombucha, Energy Drinks (Red Bull, Monster, Sting)
Alcohol (where permitted): Beer (Kingfisher, Budweiser), Wine (Red, White, Rosé), Whisky, Rum, Vodka, Brandy, Gin

6. Snacks, Sweets & Dry Fruits
Biscuits & Cookies: Parle-G, Marie Gold, Good Day, Bourbon, Oreo, Hide & Seek, Jim Jam, Digestive, Cream Crackers, Butter Cookies
Namkeen & Savories: Aloo Bhujia, Sev, Moong Dal Namkeen, Boondi, Mixture, Chivda, Masala Peanuts, Murukku, Shankarpali, Khatta Meetha
Packaged Snacks: Potato Chips (Lays, Kurkure), Popcorn (Butter, Caramel), Tortilla Chips, Pretzels, Cheese Balls, Corn Puffs
Sweets & Candies: Dairy Milk, KitKat, Snickers, Eclairs, Center Fresh, Gummies, Barfi (Besan, Coconut), Laddoo (Besan, Motichoor), Gulab Jamun (Ready-to-fry, Canned), Rasgulla (Canned), Peda
Dry Fruits & Nuts: Almonds, Cashews, Walnuts, Pistachios, Raisins (Kishmish), Dates (Khajoor, Medjool), Fox Nuts (Makhana), Sunflower Seeds, Pumpkin Seeds, Chia Seeds
Health Snacks: Granola Bars, Protein Bars, Trail Mix, Roasted Chana, Roasted Makhana, Multigrain Crackers

7. Dairy, Eggs & Plant-Based Alternatives
Milk & Cream: Full Cream Milk, Toned Milk, Skimmed Milk, Double Toned, Tetra Pack Milk, Flavored Milk (Chocolate, Badam), UHT Milk, Condensed Milk, Evaporated Milk
Butter & Cheese: Amul Butter, Cheese Slices, Cheddar, Mozzarella, Feta, Cream Cheese, Processed Cheese, Gouda, Ricotta, Paneer Spread
Yogurt & Curd: Plain Dahi, Flavored Yogurt (Strawberry, Mango), Greek Yogurt, Probiotic Yogurt, Hung Curd
Paneer & Tofu: Fresh Paneer, Malai Paneer, Frozen Paneer, Firm Tofu, Silken Tofu, Smoked Tofu
Eggs: Regular Chicken Eggs, Omega-3 Enriched Eggs, Brown Eggs, Free-range Eggs
Plant Alternatives: Almond Milk, Soy Milk, Oat Milk, Coconut Milk, Cashew Cheese, Vegan Yogurt

8. Frozen Foods
Frozen Vegetables: Peas, Sweet Corn, Mixed Vegetables, Spinach, Broccoli Florets, Green Beans
Frozen Snacks & Meals: French Fries, Nuggets (Chicken, Veg), Spring Rolls, Samosas, Cutlets, Pizza (Cheese, Veg, Chicken), Parathas (Aloo, Plain), Kulchas
Frozen Desserts: Ice Cream (Cups, Tubs, Cones), Ice Pops, Kulfi, Waffles, Pancakes, Frozen Fruit Pulp (Mango, Berry)

9. Fresh Produce
Fruits: Apple, Banana, Orange, Grapes, Papaya, Pears, Watermelon, Guava, Mango, Pineapple, Kiwi, Avocado, Pomegranate, Lemon, Lime, Sweet Lime (Mosambi), Grapefruit, Strawberry, Blueberry, Raspberry, Cherry, Peach, Plum, Nectarine, Cantaloupe, Honeydew
Vegetables: Spinach (Palak), Fenugreek (Methi), Lettuce, Kale, Coriander Leaves, Salad Greens, Potato, Onion, Garlic, Ginger, Carrot, Beetroot, Radish, Sweet Potato, Turnip, Tomato, Brinjal, Capsicum, Okra, Cucumber, Pumpkin, Bitter Gourd, Bottle Gourd, Cauliflower, Broccoli, Cabbage, Celery, Asparagus, Artichoke, French Beans, Cluster Beans, Peas (Matar), Lima Beans

10. Meat, Poultry, Seafood & Processed Meats
Poultry: Chicken (Whole, Breast, Thighs, Drumsticks), Turkey
Red Meat: Mutton (Goat), Lamb, Pork, Beef (where legal)
Seafood: Fish (Rohu, Catla, Pomfret, Salmon, Tuna, Cod), Prawns, Shrimp, Squid, Crab, Mussels
Processed Meats: Bacon, Sausages (Chicken, Pork), Ham, Hot Dogs, Deli Slices, Salami, Pepperoni

11. Meat & Dairy Alternatives (Plant-Based)
Plant Proteins: Tofu, Tempeh, Seitan, Textured Vegetable Protein (TVP)
Veggie Meats: Soy Burgers, Veggie Sausages, Quorn Nuggets, Jackfruit Pulled “Pork”, Lentil Meatballs
Dairy-Free: Almond Milk, Soy Milk, Oat Milk, Coconut Milk, Cashew Cheese, Vegan Yogurt

12. Packaged, Canned & Ready-to-Eat Foods
Canned Vegetables: Tomatoes (Diced, Crushed), Corn, Peas, Carrots, Mushrooms, Olives, Artichokes
Canned Fruits: Pineapple, Mango, Peach, Pear, Mixed Fruit, Cherries (Maraschino)
Legumes & Beans: Chickpeas, Black Beans, Kidney Beans, Cooked Lentils, Baked Beans
Spreads & Preserves: Peanut Butter (Crunchy, Smooth), Almond Butter, Jam (Strawberry, Mixed Fruit), Jelly, Marmalade, Nutella, Tahini
Ready Meals: MTR Meals, Haldiram’s, ITC Kitchen of India, Frozen Curries, Instant Soups (Tomato, Veg, Chicken), Cup Noodles

13. Bakery, Breads & Fresh Baked Goods
Breads: White Bread, Whole Wheat, Multigrain, Brown Bread, Pita, Wraps, Tortillas, Burger Buns, Hot Dog Buns, Bagels, Ciabatta, Naan (Frozen), Roti (Ready-to-cook)
Baked Goods: Cakes (Sponge, Chocolate), Muffins, Donuts, Croissants, Danish Pastries, Brownies, Scones
Traditional: Naan Khatai, Nankhatai, Rusks, Biscotti

14. Instant & Quick Mixes
Breakfast: Idli/Dosa Batter (Ready-to-use), Poha Mix, Upma Mix, Pongal Mix
Dessert: Cake Mix, Pancake Mix, Gulab Jamun Mix, Halwa Mix
Beverage & Soup: Instant Soup, Premix Masala Chai, Health Drink Powders, Protein Shake Premix

15. Household Cleaning & Paper Products
Laundry: Detergent Powder (Surf Excel, Ariel), Liquid Detergent, Fabric Softener (Comfort), Stain Removers, Bleach
Dishwashing: Vim Bar, Pril Liquid, Dishwasher Tablets, Dishwashing Sponge
Surface Cleaners: Lizol Disinfectant, Harpic, Phenyl, Glass Cleaner, Multipurpose Spray
Cleaning Tools: Brooms, Mops, Scrubbers, Sponges, Dustpans, Gloves, Garbage Bags (Biodegradable, HDPE)
Paper Products: Toilet Paper, Paper Towels, Facial Tissues, Napkins, Kitchen Rolls

16. Personal Care & Toiletries
Bath & Body: Soaps (Lifebuoy, Dettol, Dove, Lux, Cinthol), Shower Gels, Hand Wash, Body Wash, Loofah
Hair Care: Shampoo (Head & Shoulders, Pantene, Clinic Plus), Conditioner, Hair Oil (Parachute, Amla), Hair Gel, Hair Serum, Hair Color
Oral Care: Toothpaste (Colgate, Sensodyne), Mouthwash (Listerine), Dental Floss, Tongue Cleaners, Toothbrushes
Fragrance: Deodorants (Rexona, Nivea, Fogg), Perfumes (Skinn, Engage), Body Mists, Roll-ons
Men’s Grooming: Razors (Gillette), Shaving Foam, Aftershave, Trimmers
Women’s Hygiene: Sanitary Pads (Whisper, Stayfree), Tampons, Menstrual Cups, Intimate Wash, Wet Wipes
Skincare: Moisturizer, Sunscreen, Lip Balm, Face Wash, Face Masks

17. Beauty, Cosmetics & Makeup
Face Makeup: Foundation, Concealer, Compact Powder, Blush, Bronzer, Highlighter
Eye Makeup: Eyeshadow Palettes, Eyeliner (Pencil, Gel, Liquid), Mascara, Eyebrow Pencil
Lip Products: Lipstick, Lip Gloss, Lip Liner, Lip Balm, Matte Liquid Lipstick
Nail Care: Nail Polish, Nail Polish Remover, Nail Files, Cuticle Oil
Makeup Tools: Beauty Blender, Makeup Brushes, Eyelash Curler, Tweezers, Mirror
Advanced Skincare: Serums, Face Masks, Under-Eye Cream, Face Oils, Sheet Masks
Beauty Accessories: Makeup Bags, Cosmetic Organizers, False Lashes, Lash Glue

18. Baby Care
Feeding: Infant Formula (Nan, Lactogen), Baby Cereal, Fruit/Veg Purees, Biscuits (Teething)
Hygiene: Diapers (Pampers, Huggies), Baby Wipes, Diaper Rash Cream, Baby Powder, Baby Oil
Grooming: Baby Shampoo, Baby Soap, Nail Clippers, Bath Towels

19. Pet Care
Food: Dog Food (Pedigree, Drools), Cat Food (Whiskas), Bird Seed, Fish Food, Treats
Hygiene: Pet Shampoo, Flea & Tick Spray, Litter (Clay, Silica), Poop Bags, Ear Cleaners
Accessories: Collars, Leashes, Bowls, Toys (Chew, Interactive), Beds, Grooming Brushes

20. School & Children Items
Stationery: Notebooks, Pens, Pencils, Markers, Erasers, Scissors, Glue, Sticky Notes, Geometry Box, Art Files
School Bags: Trolley Bags, Backpacks, Sling Bags
Art & Craft: Chart Paper, Poster Colors, Watercolors, Crayons, Glitter, Origami Paper, Clay (Play-Doh, Air-dry)
Learning Aids: Flashcards, Abacus, Educational Toys, Storybooks
Lunch & Drink: Tiffin Boxes, Water Bottles, Insulated Bags
Uniform & Accessories: School Belts, Socks, Hair Bands, ID Card Holders

21. Pooja & Religious Items
Pooja Samagri: Camphor, Ghee Diya, Incense Sticks (Agarbatti), Havan Samagri, Kumkum, Turmeric Powder
Idols & Pictures: Krishna, Ganesha, Lakshmi, Sai Baba, Wall Posters
Pooja Utensils: Brass Diya, Puja Thali, Bell, Conch Shell, Kalash
Ritual Items: Rudraksha Mala, Tulsi Mala, Red Chunri, Pooja Cloths
Festival Decor: Diyas (Decorative), Rangoli Colors, Torans, String Lights

22. Fragrance & Aromatherapy
Perfumes: Men’s Eau de Parfum, Women’s Perfume, Unisex Fragrances
Deodorants: Roll-on, Spray, Stick (Long-lasting)
Room Fragrance: Reed Diffusers, Electric Diffusers, Scented Candles, Incense Holders
Essential Oils: Lavender, Eucalyptus, Tea Tree, Peppermint, Lemon
Car Perfumes: Hanging, Vent Clip, Gel-based

23. Bathroom Essentials
Fixtures: Shower Curtains, Bath Mats, Toilet Seat Covers, Towel Rails
Storage: Soap Dishes, Toothbrush Holders, Bathroom Caddies, Mirrors
Hygiene: Toilet Brushes, Plungers, Drain Cleaners, Air Fresheners
Personal: Bath Towels, Hand Towels, Loofah, Bath Sponges, Shower Caps
Safety: Non-slip Mats, Grab Bars, Night Lights

24. Home Textiles & Bedding
Bed Linen: Bedsheets (Fitted/Flat), Pillow Covers, Duvet Covers, Quilt Covers
Blankets & Quilts: Cotton, Acrylic, Fleece, Electric Blankets
Bath Linen: Towels, Hand Towels, Bath Mats, Face Towels
Floor Mats: Cotton, Coir, Rubber, Anti-Slip, Designer Doormats
Curtains: Sheer, Blackout, Thermal, Ready-Made Panels
Cushion Covers: Cotton, Velvet, Polyester, Seasonal Prints

25. Apparel & Fashion
Men’s Clothing: T-shirts, Shirts, Jeans, Trousers, Kurtas, Ethnic Sets
Women’s Clothing: Sarees, Kurtis, Tops, Leggings, Dresses, Ethnic Suits
Kids’ Clothing: Frocks, Shirts, Tracksuits, School Uniforms
Footwear: Sandals, Sports Shoes, Formal Shoes, Slippers, School Shoes
Innerwear: Vests, Bras, Trunks, Boxers, Thermal Wear
Activewear: Track Pants, Sports Bras, Gym T-shirts
Fashion Accessories:
 – Bags & Wallets: Tote, Clutch, Backpack, Wallet
 – Jewelry: Earrings, Necklaces, Bracelets (Fashion)
 – Others: Sunglasses, Watches, Belts, Scarves, Hats

26. Home Furniture & Furnishings
Living Room: Sofas, Center Tables, TV Units, Bookshelves
Bedroom: Beds, Mattresses, Wardrobes, Nightstands
Dining: Dining Tables, Chairs, Bar Stools
Study: Study Tables, Office Chairs, Filing Cabinets
Modular: Shoe Racks, Kitchen Cabinets, Wall Shelves
Outdoor: Garden Chairs, Balcony Tables, Swing Sets

27. Gardening & Indoor Plants
Gardening Tools: Trowels, Pruners, Gloves, Watering Cans
Supplies: Potting Mix, Vermicompost, NPK Fertilizer, Neem Oil
Pots & Plants: Terracotta Pots, Succulents, Snake Plant, Peace Lily, Orchids
Plant Care: Moisture Meters, Trellis, Mulch, Insecticidal Soap

28. Electronics & House Appliances
Small Appliances: Electric Kettle, Mixer Grinder, Toaster, Microwave Oven, Electric Iron, Air Fryer, Juicer
Lighting: LED Bulbs, Tube Lights, CFLs, Night Lamps, Chandeliers, Ceiling Lights, Strip Lights
Batteries: AA, AAA, 9V, Rechargeable (NiMH), Button Cells
Cables & Chargers: USB Cables, Mobile Chargers, Power Banks, HDMI, Earphones, AUX Cables
Fans: Ceiling, Table, Pedestal, Exhaust, Wall-Mounted
Switches & Sockets: Modular Switches, Sockets, Plugs, Adaptors, Extension Boards
Home Entertainment: TVs, Soundbars, Bluetooth Speakers, Home Theaters
Power Protection: Voltage Stabilizers, Surge Protectors, UPS, Smoke Detectors
Computing: Mouse, Keyboard, Laptop Stands, Webcams, USB Hubs

29. Mini Repair & Hardware Kit
Basic Tools: Screwdrivers, Hammer, Pliers, Wrench, Tape Measure
Fasteners: Nails, Screws, Hooks, Anchors, Cable Ties
Adhesives: Fevicol, M-Seal, Super Glue, Silicone Sealant
Electrical: Insulation Tape, Wire Connectors, Fuse, Bulb Holder
Plumbing: Teflon Tape, Washers, Pipe Joint Compound
Safety: Work Gloves, Safety Goggles, Utility Knife

30. Computer & Office Essentials
Peripherals: Mouse, Keyboard, Headset, Webcam, Speakers
Storage: Pen Drives, External HDD, SSD, Memory Cards
Printing: Ink Cartridges, Toner, Printer Paper, Label Stickers
Cables & Adapters: HDMI, VGA, USB-C Hub, Ethernet Cable
Office Supplies: Files, Folders, Stapler, Punch Machine, Paper Clips, Sticky Notes
Desk Organizers: Pen Holders, Drawer Trays, Cable Management Clips

